111111111111111
1C110000000C101
101001111100101
1P0011E00000101
111111111111111