1111111111111
10010C00000C1
1000011110001
1P0011E000001
11111111111C1
1111111111111
